Afghanistan - Kaboul
Afrique du Sud - Bloemfontein
Afrique du Sud - Le Cap
Afrique du Sud - Pretoria
Albanie - Tirana
Algérie - Alger
Allemagne - Berlin
Andorre - Andorre-la-Vieille
Angola - Luanda
Antigua-et-Barbuda - Saint John's
Arabie Saoudite - Riyad
Argentine - Buenos Aires
Arménie - Erevan
Australie - Canberra
Autriche - Vienne
Azerbaïdjan - Bakou
Bahamas - Nassau
Bahreïn - Manama
Bangladesh - Dacca
Barbade - Bridgetown
Belgique - Bruxelles
Belize - Belmopan
Bénin - Porto-Novo
Bhoutan - Thimphou
Biélorussie - Minsk
Birmanie - Naypyidaw
Bolivie - La Paz
Bolivie - Sucre
Bosnie-Herzégovine - Sarajevo
Botswana - Gaborone
Brésil - Brasilia
Brunei - Bandar Seri Begawan
Bulgarie - Sofia
Burkina Faso - Ouagadougou
Burundi - Gitega
Cambodge - Phnom Penh
Cameroun - Yaoundé
Canada - Ottawa
Cap-Vert - Praia
Centrafrique - Bangui
Chili - Santiago
Chine - Pékin
Chypre - Nicosie
Colombie - Bogota
Comores - Moroni
Congo - Brazzaville
RD Congo - Kinshasa
Cook (Îles) - Avarua
Corée du Nord - Pyongyang
Corée du Sud - Séoul
Costa Rica - San José
Côte d'Ivoire - Yamoussoukro
Croatie - Zagreb
Cuba - La Havane
Danemark - Copenhague
Djibouti - Djibouti
Dominicaine - Saint-Domingue
Dominique - Roseau
Égypte - Le Caire
Émirats arabes unis - Abou Dabi
Équateur - Quito
Érythrée - Asmara
Espagne - Madrid
Estonie - Tallinn
États-Unis - Washington
Éthiopie - Addis-Abeba
Fidji - Suva
Finlande - Helsinki
France - Paris
Gabon - Libreville
Gambie - Banjul
Géorgie - Tbilissi
Ghana - Accra
Grèce - Athènes
Grenade - Saint-Georges
Guatemala - Guatemala
Guinée - Conakry
Guinée équatoriale - Malabo
Guinée-Bissau - Bissau
Guyana - Georgetown
Haïti - Port-au-Prince
Honduras - Tegucigalpa
Hongrie - Budapest
Inde - New Delhi
Indonésie - Jakarta
Irak - Bagdad
Iran - Téhéran
Irlande - Dublin
Islande - Reykjavik
Israël - Jérusalem
Italie - Rome
Jamaïque - Kingston
Japon - Tokyo
Jordanie - Amman
Kazakhstan - Astana
Kenya - Nairobi
Kirghizistan - Bichkek
Kiribati - Tarawa-Sud
Koweït - Koweït
Laos - Vientiane
Lesotho - Maseru
Lettonie - Riga
Liban - Beyrouth
Liberia - Monrovia
Libye - Tripoli
Liechtenstein - Vaduz
Lituanie - Vilnius
Luxembourg - Luxembourg
Macédoine - Skopje
Madagascar - Antananarivo
Malaisie - Kuala Lumpur
Malaisie - Putrajaya
Malawi - Lilongwe
Maldives - Malé
Mali - Bamako
Malte - La Valette
Maroc - Rabat
Marshall - Delap-Uliga-Darrit
Marshall - Majuro
Maurice - Port-Louis
Mauritanie - Nouakchott
Mexique - Mexico
Micronésie - Palikir
Moldavie - Chisinau
Monaco - Monaco
Mongolie - Oulan-Bator
Monténégro - Podgorica
Mozambique - Maputo
Namibie - Windhoek
Nauru - Yaren
Népal - Katmandou
Nicaragua - Managua
Niger - Niamey
Nigéria - Abuja
Niue - Alofi
Norvège - Oslo
Nouvelle-Zélande - Wellington
Oman - Mascate
Ouganda - Kampala
Ouzbékistan - Tachkent
Pakistan - Islamabad
Palaos - Melekeok
Palestine - Jérusalem-Est
Palestine - Ramallah
Panama - Panama
Papouasie-Nouvelle-Guinée - Port Moresby
Paraguay - Asuncion
Pays-Bas - Amsterdam
Pays-Bas - La Haye
Pérou - Lima
Philippines - Manille
Pologne - Varsovie
Portugal - Lisbonne
Qatar - Doha
Roumanie - Bucarest
Royaume-Uni - Londres
Russie - Moscou
Rwanda - Kigali
Saint-Christophe-et-Niévès - Basseterre
Sainte-Lucie - Castries
Saint-Marin - Saint-Marin
Saint-Vincent-et-les-Grenadines - Kingstown
Salomon - Honiara
Salvador - San Salvador
Samoa - Apia
Sao Tomé-et-Principe - Sao Tomé
Sénégal - Dakar
Serbie - Belgrade
Seychelles - Victoria
Sierra Leone - Freetown
Singapour - Singapour
Slovaquie - Bratislava
Slovénie - Ljubljana
Somalie - Mogadiscio
Soudan - Khartoum
Soudan du Sud - Djouba
Sri Lanka - Sri Jayawardenapura
Sri Lanka - Colombo
Suède - Stockholm
Suisse - Berne
Suriname - Paramaribo
Swaziland - Mbabane
Swaziland - Lobamba
Syrie - Damas
Tadjikistan - Douchanbé
Tanzanie - Dodoma
Tchad - N'Djamena
Tchéquie - Prague
Thaïlande - Bangkok
Timor Oriental - Dili
Togo - Lomé
Tonga - Nuku'alofa
Trinité-et-Tobago - Port-d'Espagne
Tunisie - Tunis
Turkménistan - Achgabat
Turquie - Ankara
Tuvalu - Funafuti
Ukraine - Kiev
Uruguay - Montevideo
Vanuatu - Port-Vila
Vatican - Vatican
Vénézuela - Caracas
Viêt Nam - Hanoï
Yémen - Aden
Yémen - Sanaa
Zambie - Lusaka
Zimbabwe - Harare